CDRa	CDRb	Counts
CAAPGNTPLVF	CAISETTGINEQFF	1
CAAFSGGGADGLTF	CASMRGAHTGELFF	1
CAVNPTGYSTLTF	CASNSGGYNEQFF	1
CAGNTGNQFYF	CASRPQGLGNTIYF	1
CGGQAGTALIF	CASRSYVASSNEQFF	1
CAVSGGGADGLTF	CASSALGINEQFF	1
CAMTLSNFGNEKLTF	CASSDMAGDGYTF	1
CALPSGNTPLVF	CASSDPGSGAYEQYF	1
CAVNKGFQKLVF	CASSDSYEQYF	1
CAVNTGFQKLVF	CASSEANEKLFF	1
CAVNPGGADGLTF	CASSEAPGTSVGGLFF	1
CAVTTDSWGKLQF	CASSEGGIGELFF	1
CAVTAGGTSYGKLTF	CASSFAGTTEAFF	1
CAVTGGGTSYGKLTF	CASSFALSNEAFF	1
CAVTGQGGKLIF	CASSFGGGGQPQHF	1
CAASGGGADGLTF	CASSFGGLARNEQFF	1
CAVQGGGSQGNLIF	CASSLAGQVFSGELFF	1
CAVPTNFGNEKLTF	CASSLEGTGLTDTQYF	1
CAVIRSGGYNKLIF	CASSLELAGGPAFF	1
CAPPGDGNNRLAF	CASSLGAGGGGTQYF	1
CAAFTSGNTPLVF	CASSLGGLGQPQHF	1
CAASKEAAGNKLTF	CASSLGLGQPQHF	1
CAVKDGQNFVF	CASSLGLGQPQHF	1
CAAEFYF	CASSLGQGQPQHF	1
CAVGLGFGNVLHC	CASSLGVGTEAFF	1
CAGLNNARLMF	CASSLQGGYGGGYTF	1
CASTGGKLIF	CASSLSTVFTDTQYF	1
CAVGREAAGNKLTF	CASSLTSGSFAGELFF	1
CAVGRDDKIIF	CASSLTTGVFSQPQHF	1
CAAPSGNTPLVF	CASSMAGEQYF	1
CAASLGGGADGLTF	CASSPDVGHEKLFF	1
CAVNRDNFNKFYF	CASSPEPGSHEQYF	1
CAGGGGSSNTGKLIF	CASSPGGTEAFF	1
CAMSQSNFGNEKLTF	CASSPGQSPTNEKLFF	1
CALAIGFGNVLHC	CASSPIGGGSNEQFF	1
CAVNTGFQKLVF	CASSPNLAGEEQYF	1
CALSRPSRGSQGNLIF	CASSPQGSGGEAFF	1
CAVRSERSGGGADGLTF	CASSPSPAGAYEQYF	1
CAVGGGSQGNLIF	CASSPYRTGNIQYF	1
CAVSDGQKLLF	CASSQAGVGGELFF	1
CAVNGNNRLAF	CASSQAPLASGGYTF	1
CAVANAGNMLTF	CASSQEVGLAGETQYF	1
CASDNNARLMF	CASSQEVVANNEQFF	1
CAALTGNQFYF	CASSQGSGQPQHF	1
CAAGGSQGNLIF	CASSQGTINTGELFF	1
CAVNLNQAGTALIF	CASSQVGSTEAFF	1
CAVRTQIIF	CASSRSPGGVYEQYF	1
CAVEGSRLTF	CASSSGPTMGGKLFF	1
CAVNTGFQKLVF	CASSSPGGETQYF	1
CAASGGGADGLTF	CASSSTVYNEQFF	1
CALPKGGYSTLTF	CASSTTGTGLLEQYF	1
CAVNVQGGSEKLVF	CASSWTGGGQPQHF	1
CAMREGTGRRALTF	CASSYFGGSLSEQYF	60
CAMREGTGRRALTF	CASSYFRGSLSEQYF	1
CAVSGTASKLTF	CASSYGTGDGYTF	1
CAVTRGGADGLTF	CASSYSGLGQPQHF	1
CAVNVANDMRF	CASSYSIGNTEAFF	1
CAGSGGGYQKVTF	CASSYSQGVYTGELFF	1
CAGYKLVF	CASSYSQGVYTGELFF	1
CAVNTGGGADGLTF	CASTQGDTGELFF	1
CAVNGGNQFYF	CASTQWYGGGTPPYF	1
CAVSGSARQLTF	CASTTGDGLGAFF	1
CAVPTFVNTGKLIF	CASTYGGLNEQYF	1
CAPTIYNQGGKLIF	CATSGSYEQYF	1
CAVNGGGKLTF	CATSGSYEQYF	1
CATCMDSNYQLIW	CATSPYSVTTFANTIYF	1
CAADNYGQNFVF	CAWSVSGLGYGYTF	1
CAVSSYDKVIF	CSALTGNQPQHF	1
CAVNIPTF	CSARDGTSSGYF	1
CVVNPFGNEKLTF	CSARHPGVSTDTQYF	1
