CDRa	CDRb	Counts
CAMREGTGRRALTF	CASSYFGGSLSEQYF	18
CAVGEYGNKLVF	CASSPGPYEQYF	1
CVVNEYSSASKIIF	CASSQGWDEQYF	1
CAVYSGGYNKLIF	CASSFVNTGELFF	1
CAVNDYKLSF	CASSWTGANYGYTF	1
CAMREGMDSSYKLIF	CASMTNNQPQHF	1
CAVGMDSSYKLIF	CASNQPQHF	1
CVVSAMGGGNKLTF	CASNQPQHF	1
CALSEAGYGNNRLAF	CASSESFPASGGSTDTQYF	1
CAVQAADSSASKIIF	CASSFWAGGWTEAFF	1
CATGDLGNQFYF	CASSLGFGYEQFF	1
CLAFSGGYNKLIF	CASSLGPAYNEQFF	1
CVVSVSGGYNKLIF	CASSLVESEQFF	1
CAVGIYNQGGKLIF	CASSPGLDYEQYF	1
CAMRGGLYNFNKFYF	CASSPQGQGESGANVLTF	1
CAGFSGGYNKLIF	CASSRGTGGYEQFF	1
CLVGDVQEGFQKLVF	CSARDPSQGGYEQYF	1
CAVILQGAQKLVF	CSARGAGVPYEQYF	1
CAVSSITQGGSEKLVF	CSARGAGVPYEQYF	1
CADYYGQNFVF	CASSFQGYTEAFF	3
CATNTGNQFYF	CASSPTTRTRYYGYTF	1
CAAPRETSYDKVIF	CASSSANYGYTF	28
CAGPMKTSYDKVIF	CASSSANYGYTF	3
CAGPTKTSYDKVIF	CASSSANYGYTF	3
CAMRAFGADGQKLLF	CASSYATEVAGETQYF	1
CAVNYGNMLTF	CASSYATEVAGETQYF	1
CAVFYGNKLVF	CASSYATGIPDTQYF	6
CARNTGNQFYF	CASSYSTGTAYGYTF	1
CILSNNNDMRF	CAWSISDSSRVEAFF	8
CVVNLPNTGFQKLVF	CASRTGTSGGFPNTGELFF	1
CALRIGGSTLGRLYF	CASSASGGRDYGYTF	1
CAVSSGTYKYIF	CASSLLGNTEAFF	1
CAMSVGGLTGGGNKLTF	CASSLSGQGATNEKLFF	1
CAVITGGGNKLTF	CASSLAGGGEQYF	1
CATGLNYGGSQGNLIF	CASSLFNQETQYF	1
CASSGLSSGGSYIPTF	CASSPLRGPADRTGTEAFF	8
CAVKGGGADGLTF	CSALTGSSYEQYF	1
CAAYNAGNMLTF	CASSHRGSGNTIYF	1
CAVNRDSGTYKYIF	CASSFEWSYEQYF	1
CAVSFGSSNTGKLIF	CASGFTFQGSPEAFF	1
CAVRYSSASKIIF	CASRPGGGGYTF	1
CALSPGYNFNKFYF	CASSSRDRSSSTEAFF	1
CIVRGFAYGQNFVF	CASSSRDRSSSTEAFF	1
CAFGDNYGQNFVF	CASSTALAASYEQYF	1
CAGGPYNTDKLIF	CASSTTEAYEQYF	1
CAVRDDTGGFKTIF	CASSTTEAYEQYF	1
CAVGRDGNQFYF	CASSTTGGGNYEQYF	1
CAGLADSNYQLIW	CASSVGSGGRPSSYNEQFF	1
CAMREGTGRRALTF	CATHGVSSRETQYF	1
CAVSFGSSNTGKLIF	CASGFTFQGSPEAFF	1
CALSPGYNFNKFYF	CASSSRDRSSSTEAFF	1
CIVRGFAYGQNFVF	CASSSRDRSSSTEAFF	1
CAFGDNYGQNFVF	CASSTALAASYEQYF	1
CAGGPYNTDKLIF	CASSTTEAYEQYF	1
CAVRDDTGGFKTIF	CASSTTEAYEQYF	1
CAVGRDGNQFYF	CASSTTGGGNYEQYF	1
CAGLADSNYQLIW	CASSVGSGGRPSSYNEQFF	1
CAMREGTGRRALTF	CATHGVSSRETQYF	1
CAPGIAGGTSYGKLTF	CASSLAYSYEQYF	1
CAAYNAGNMLTF	CASSHRGSGNTIYF	1
CVVNGGGYQKVTF	CASSAGLFPEQFF	1
CAVMADGQKLLF	CASSQTIGTGFSNEQFF	1
CAYRSPPSSEKLVF	CASSFLGTGLNEQYF	1
CAYRSPPSSEKLVF	CASSFLGTGLNEQYF	15
CALLDGNKLVF	CASSIGLNQPQHF	1
CASLRNMLTF	CASSIGLNQPQHF	1
CAYRSPPSSEKLVF	CASSFLGTGLNEQYF	14
CAYRLGGSEKLVF	CASSFPPAGTGELFF	1
CALLDGNKLVF	CASSIGLNQPQHF	1
CASLRNMLTF	CASSIGLNQPQHF	1
CALDAGNMLTF	CASLGLEYEQYF	1
CAVRDMHPRGYNKLIF	CATRGGEGQPQHF	1
CLVGGYSGGYQKVTF	CATRGGEGQPQHF	1
CAVEGSRLTF	CASSEVRGPWAETQYF	1
CAVSETGAGNNRKLIW	CASSEVRGPWAETQYF	1
CAVGSARQLTF	CATSVGSGPLSTDTQYF	1
CAMREGTTDSWGKLQF	CSARDLGLHQPQHF	1
CVVNGGGYQKVTF	CASSAGLFPEQFF	1
CAASASTDKLIF	CASSLGLADPNNEQFF	1
CAYSMLDRLMF	CATRKSYNSPLHF	1
CAMSLSNFGNEKLTF	CSARDGGLAGEQKVGDTQYF	1
CAYRSALWGAQKLVF	CASSLAENSGNTIYF	1
CAVSSYDKVIF	CSALTGNQPQHF	1
CAVNGDSGGSNYKLTF	CASSLWGAGELFF	1
CVVADDKIIF	CASSVDGGSQPQHF	1
CAMSQDYNTDKLIF	CASRTRQEAFF	1
CAGGGSQGNLIF	CASSIRSSYEQYF	1
CATDAVSGTGGTSYGKLTF	CASSIYGAGYTEAFF	1
CAGAGGGSQGNLIF	CASSPRSTDTQYF	1
CATNTGNQFYF	CASSPTTRTRYYGYTF	1
CDPSGGNNRKLIW	CASSVYSGGYNEQFF	1
CAVSPFGNVLHC	CASTGQNPEAFF	1
CGTLRNNNARLMF	CASWDRGNEQFF	1
CATDEVDSSYKLIF	CASTSYTEAFF	1
CALSLAEGNFNKFYF	CASTWTGEQYF	1
CAVGAGPGAGSYQLTF	CASRSHPTYEQYF	1
CAVSVITQGGSEKLVF	CASSAGRYEQYF	1
CAYYGGSQGNLIF	CASSATGVSPYEQYF	1
CAMRVRTWGQNFVF	CASSFANSPLHF	1
CASSGLSSGGSYIPTF	CASSPLRGPADRTGTEAFF	1
CAVNNDYKLSF	CASSQEMASVQETQYF	1
CVVTASNDMRF	CASSQETSPNYGYTF	1
CAVNQAGTALIF	CASSQTGTGAYEQYF	1
CALNFGNEKLTF	CASSSGPRGNEQFF	1
CAVITGGGNKLTF	CASSVAGSTEAFF	1
CAATQGGSEKLVF	CASSVGVGTDTQYF	1
CAVRDMGSNYQLIW	CASSYAQGAETQYF	1
CAMREGTGRRALTF	CASSYFGGSLSEQYF	11
CAMREGPGGTSYGKLTF	CASSYRQDSNQPQHF	1
CAYGSNNNDMRF	CASSYSPGTGNTIYF	1
CAVSDLNYGQNFVF	CASTYGGGALNEQFF	1
CAEYSSASKIIF	CSANRQGSIYF	1
CAMRELTSGTYKYIF	CSPLGGQGVWDEQFF	1
CAGVPSNTGKLIF	CASSPWRGPFQETQYF	1
CALPNFGNEKLTF	CASSYRFDSPLHF	1
CATDGEDDSWGKLQF	CASVLGGSSYNEQFF	1
CAMSESDGQKLLF	CASSLVPLSPEQYF	1
CAVNPRDNYGQNFVF	CASSQDIGNFEQFF	1
CVVNFPTNAGKSTF	CASSLGQGLSYEQYF	1
CATGFSGAGSYQLTF	CASSLVMDNYGYTF	1
CAVEGSRLTF	CASSLVMDNYGYTF	1
CASLGQGAQKLVF	CAISEASGVTYEQYF	1
CAVNSDGQKLLF	CAISEGAAYGYTF	1
CAAKDNRKLIW	CASGPGTAYGYTF	1
CAGASTGDYKLSF	CASGRGPNYGYTF	1
CAGRSYNTNAGKSTF	CASSEALYEQYF	1
CAVTDYKLSF	CASSEALYEQYF	1
CAVSDDKIIF	CASSEGPGQGSYEQYF	1
CAVDRDDKIIF	CASSFDLAGVNYEQYF	1
CVVNDNDMRF	CASSFGASYGYTF	1
CVVNMGKNGQKLLF	CASSFGDSYEQYF	1
CAWYSGGGADGLTF	CASSFWGADTQYF	1
CAEGGGADGLTF	CASSGGYEQYF	1
CASSTDSWGKLQF	CASSHDAGASTGELFF	1
CAMRSSDPGGYNKLIF	CASSIQGRGDTEAFF	1
CAVTGNQFYF	CASSLGGQGAYEQYF	1
CVVSDDKIIF	CASSLTALGAAYVYTF	1
CVVNNDKIIF	CASSLTPSASGYEQYF	1
CAVVGGYNKLIF	CASSPGQVSYEQYF	1
CVVAEARLMF	CASSPGTGGTYEQYF	1
CAVTNDKIIF	CASSPMNEQFF	1
CAVGSDSSYKLIF	CASSQAQGTYEQYF	1
CALQDDKIIF	CASSQGAAYEQYF	1
CAVNEGTGNQFYF	CASSQGGGTEAFF	1
CAVIGSGKLIF	CASSQTAGGYEQYF	1
CVVADDKIIF	CASSVDGGSQPQHF	1
CARNTGNQFYF	CASSVGGVPYNEQFF	1
CIVAAISGSARQLTF	CASSYGGGYEQYF	1
CAGNNARLMF	CATSPRGGHEQYF	1
CAVSDDKIIF	CATSRTGTGSTEAFF	1
CAPGDDKIIF	CATSSSGAYEQYF	1
CAFEGGKLIF	CSAIGPRGTDTQYF	1
CAVRLGGADGLTF	CSAWWGAEQYF	1
CALSGSDSWGKLQF	CASSESTIVQGYNEQFF	1
CAVNPSNQFYF	CASRGPYHNEQFF	1
CAMDSSYKLIF	CASSALAGGQADTQYF	1
CIVRVECMYSGGGADGLTF	CASSALAGGQADTQYF	1
CAAGGSYIPTF	CASSGTGGYSGANVLTF	1
CVVSEEYTNAGKSTF	CASSLERLRVYSGYTF	1
CAADSWGKLQF	CATSDSTGSYGYTF	1
CAVSGYSTLTF	CSVGLGQTGTEAFF	1
CSLANAGKSTF	CASSLVGGITGELFF	1
CVFPNQGGSEKLVF	CASSQDPGNGNTIYF	1
CAMSDTNAGKSTF	CASSTSAGFSNQPQHF	1
CAYRSVPDMRF	CAWSGFSRTEAFF	1
